>Rosalind_1122
GGCGTATTATTACCCTACGATTGCGCGACATAAGGTAACATCATCCGTGCCAAGCAATGA
TAGCCCTCGCTCCTCAGGCGAGGAAGTGCTCGCTCGTGTCGCCATTATAGGGAATGGGTC
CGACTTAGGCATCTCCCCCAGTGAAGAACAAAGGCACCCCTTCCCGAGGGCCCGACCTAA
CCAAAACAGCTGACGTTCAAAACTCGTGTTCAGAAGTCGTCTCGAAAGGAACTTTCGTCC
AATACCTTACTTCTCGGGCTAGTGCATATTTGCATCGTGGGTCAGGGGGCGACTGAGCAA
CCAATTGCGTCGAGTCAGACAGATGAATCCTAGCTCTCGGCGCTATGCATCCCCTGTACT
GGACCTTAGCAATAAATGTATCTATGAAGGCTTTCTCAATTTGATACCGGAAGTCGACAC
GGATGAGAGGTGAACTCTGACAACTACTCGCGGTTATCGTCAACTAACGGCCGTATAGCT
CCTGAAAATTCCTGGCCTAGCAGGTGGTGGCGGCCAACGCCAACCAAAGCCTATTCCTAG
AGTCGTGTACCAGGCCACCGTTTCAGACTCATCGAACCTCAATAAACCGGCCCGGACGCA
TGCTTCCGTTGACCCGCGATTTAGTATAACAACAAATCGCCCCGCGCGGACGCTACGTTG
AGTGCCCACCGCATCCGGCGGGCCGTCCCTCTTCCTGTGAATCGTGGCCCCGAATCCTTT
GCGAGTTTCCGAGCACGCAGTAATAAGGTGGCGGTACGATAGCAATCACACTTGAAGCTA
CGAGATACTTCTAGGCGGGTTTCTGTGCCCTTTTACAGATGCAGTATCCTCACAACGATT
ACATCTGACTACGACATAACATTTGGTGTTATTTCCTCTTAATACGGGACGAGTAAATCC
CC
>Rosalind_7544
CCACGCACCAGATATCTCTAGCGCCGGACCAGGTAGGATTTCACAACCCAATGGCGGAAT
AGCCCCAAGTTGGTGACCTCTAAAGCGATCAGAGTTGGCATTCGAACTACACGAAGGAAG
ATAAGAATGTAGCTTTCCCTCCATTCTGCATGGTATGTGCTGTCTATAAAACTATGAGAA
GCCAAACAATCGGGTGACTCGATAACGCAAGTCTGTAAATGGATAGCAGAGAAAACGTCA
GGCCCCCCCGCAAAACGTCACTACCGCTCCTGGAGTGCCCGCGGGTGTTCTCTGCGAAGA
AAGTTCGCGCCGAGGTCAATTCTGGTATTACAAAATAAGAGCATGCGGTGATCCGCTAGC
GTCAGATTAGTTGTGCTGCGAATGACCGTCAGCCGTAGAACATTACAATGCCACATTCAC
CATTCCGTGGTCTGAAGTCAGGTATCGCAATAGTGACGCCACCTAGCCCTAGCTGACTTA
TGGAAAGTTTACCTCCACACAAGCAAACCCCATGAATACAGCATAATTAATGATACCATT
CATGCGGGCCATCTGGCTCCACTTCGAAGCGACGGCACGGTCATTGTCTAGGAGGCTCGG
TGGAGACGGGGGAAGAAACGCCGTCACACGCTTTAATTCGGTGCTACCCAGAAAGTTTCC
CATATGGGTATGCCCACAGCTAATTGCTGGGCATCTAGCTGCGTGATCGCCGTAGTTTGC
TTTTCATGGGAAGGTCCTACCACTGGTGAGTCGCAGCTGGCAGAGTCCCGCCAGACCTCG
TTTAGCTCAGAACTTGCGGCGCGACCGTAACGACGGGAGTCAGATAACGTAAGCAGCGCG
ACGTTAAGTATAAACATCGAAGGAAAAGCATCTGGTCTTTTAGTCAGGGACCCCACTCCC
GT
>Rosalind_8133
GTTACTTGGATATCAGTAACTGTAAATCATCAGTAATTCTCTGTTTGCTGCGTATCGACC
ATGGGACGGATCATGTTGTCAACCTGGCACATCCGTGTTCAGATCTGCCACCTACAGATC
CGCTAAATAGGTCGATTTGGGTATTGGTACTGGGTAACCGTGCACTCGACAATACAAGCT
ACTTGGGAGTGCCACGACGCTGCACAAGGTCCACACTGGGCACATCGGGACAGGCTAACG
ACAGGGGCGTTACTGGCCTGAAATCCGTTAGTACCTTTTCCGTGAGTCTTGCTGCAACAA
CAAGGATTTTGCGCATAGCCTGCGAGGGAAGTCTAATCTTTATGTTGCCGATTTCCACAG
ACTGTCTAGATTCCCCTTACCCTTATTATTCTTACCTCATGAACGATAGTGCTGTAGAAC
TAGCCTGGTCCTTACCGCCGGTCAATTGGTCGGAACAGAGCTGAGAGATGCGTAAAGCAA
GTCGGGGTCATTATCCCCCAGTCCACTGTCTTTGGCAAACCAGATAACGGACCTAGTCTT
CAAGTTGATGCATTGGGAGAGACTTTGTGCGCAGGACGCGATTACAGTCAACATAAGCCG
GCTCCGGGCATCAGAATTGATTCGTCCTTGGCGGATCGGAGCCATAAAATTCGGAACGCT
TGCTCCACGCGGTAGCTATCCGCTGTATGACATCAAACATAACACTGAAAGAGGGCGCAG
CGCTTTGGTTCATCCGGCGTATCGCACTACAGCTAAGAAGGACATGTGTTTGACGTTGCA
AATCGTCAAGGGGTAGTAGCATGAATGGTACCACTGAAGCACTCACAGTTAGCCGGTAAT
ACTAGAGCAGTCTGGGAAACAAACGTTGCTCAAGGAGCTACGCTAAAACGAGTCACTCGC
GA
>Rosalind_3131
AGCCCACGCTGGGATGGCGAGTAGGACAAGATGCGGTTAGACGAAAACTTACTCCCGCAA
GACCGAGTGTTTCACCGTCCATCCTATACGGCAGTTGGGCCAGTTTACAGTCGAAGACTG
ACGATTATAACATATTAGCTTAACAATCCGCCGTCAGCGCAGGGACGGAAATTTGTTCTG
AACGCCGCAATGTTGCATTGCCCGACTGGATACGTGTGCACCGGTTCGTATTGGGGCCGG
ACTGTTTAGTTGATCAAGATCCCACCGCAAGAGAAGGACCACTAACGCATCAAGAAATGC
CGGAGTCAGGCATTAGATAACCCACCGGAAGCACAGGCCAGGCGGTATTCGTCGGGCTTC
TAGACACGGTTTATGACACGAAGGTGTGCTCAGAATAGCCCCAATTACGCCCACTGAATA
CCTAAATTGAATAACTACGACGATCGATCTGTTTATGTGACGAAAGATGTTTATGACATA
ATCGCAGATGTTGTGCCATACTGCAATTCTGTGAGATAGACGACGCCAGGTAGGTACACA
ACAGGCGCACAAGTATCTTTCTCCGTCAGAGGGTGAAAAGGTCGATGGAGGGGTGGCGGT
GTGGTTGACCCCATGACACGGTGTGCGGAAATACAACTACCTCATCCTAGGCCTGGGCAA
ATCTTTTTCGTGTAGTAGGGCACATACGGCAATTTTGTTTAGAATGTTGTCGAGCCGTAC
GGGCGACCCCATTACAATTACTTGCTCATGGAACGATACTGCCGACCCAGCCCCATGGAA
CCGCTATCGAAGTGCTTCTCGTAGCAGGGCGCTAATGTAGACAAGGCGACGTTTCCCTAC
CAGACGGCTGGACACAAGCCAAACCTGATGCTTCACATGTGTTTCACTTATAATAGCATA
TG
>Rosalind_8293
GAACGGAAGATGGAAGGCCGCAGTGGTCGTTGCTATCCATAGCCGTACAGTTGGGACTGG
AATCGATCATAGGGGACGGGACTAGCAAAACGAACGGATGATACGTGTGATGGTGGTTAC
GCTGCTTCAACTTGAGCCTTTGGTAGTTGATACGGCTTCCATACCCTGGCGGCGCTTTCC
TGTGAGATAATAGGGCATGGGCCCGTTTACATACGGAAGCACGTGGGACCTTTGGGATGG
AACGCTATCATCGTGGACCCATACAAAGGTGAGGATTGCCGTGCTGGTACCTAGCTCTAG
GAAAACCTACTAAGCTGATTTCTCAGAAGAGTGGCCAGGACTTGGCCTGTGTTCTGAGAT
TCACAAGCAGAGTCGGGGTGGTCGACGATACGCTGACTCAGATACTTACGCACAGCCCCT
TCGACACTACGTGTGAATTGTAGCAGCAGATTCGAAGCGCCTTCAATGGGGTGGACTCCG
CATTGCATACGATGCATTCAGCCCCGCGCACTCTGCTCCGAACGGTGCCCAATTTCGCGC
TCCACGTCAAACGCTTTTCCGCTTGCTCGTCTGACGCGATCATTTACGGTGTTCAATAAT
TGGACTAGTGAAGATGTAGGCGTCGGTGAGGATTAAGTCATGGATCTTGAGGCTCGGCCC
GCTCGCGTTCACTCACGTTATGTCGCGTCAGAGCTAAGAATCATTGTCGTATAGCAGTAT
GATCAAAGTCCCCGATACTCAAAGACCGGCTGTGACCAGTTGTGATGGTAAGAAGCGCCA
GCTAGACAGTGGACCCTGGGGTCAACCGAACACAGCACGCCCCAGAGGTTTTGCCCTTTG
CGTAGCAGCGAACGATCGCTCAGGACCGGGTTCATGTCGACGTTCCTTATGATAAGTTGG
GG
>Rosalind_1804
GGTGCTTGTTCTGATCGTGCAAAACCTTGTCTGGCGATCACCAGGAAAGCACTTGGCTGC
AGAGAATCAACGCCTCTGGATAGACGGGACTGGGCGGAGTGTCGTCTGCAACACAGGTGC
CGATTGCTTCCGGTTGATGTAACAACTTACGGCGCTCACACACGCACGAGCAACCTCTAG
ATTGAGCGCCTGTACTGGGGTGGCTTCTGTTCGACTTGCCGCTCCTGAAGGCTGAAAACG
AGTAGGCTGTTCATATCTAATGCTGCCAACTGGTCATCCTTGCTCAAGACACGAGTGCTC
ACACCTGAGCCGACCCACGATCCAGCTAATTGGGGAATGACGCACGTAACCTACTTTGAA
CTCGAAGTCGGTACTTCCGTGAGCGCGTGAACTTAAGGGATGAGCGCAAGTAGGTTGGCC
ATGATTTTCAGCTAAGCTCTTTTGATTCCGCGCCAGGCCGCTGAGCCCCCATTCCCAATG
CATGTAACCTGCTTGATATCCATATGTTGACGGGAGGTCACATTAGCTGAAAAGTAAGGG
TCTAATGTATACGACAGTGGGTAAAAGGGATTTGAGGGCTGTTGGAAAGCCATGAGCCCC
GGTACTGCCGCCAGTTACGCTTAGAAAGGTGCAGAACCTCCCTCGGTAGCACACGGCAGG
AACCGATAAGCCGGGAGATGGTTAGTGACGTCAGGGCGCAACACCACAGTCAACCCGGTG
ACAACTTAGTGACCCCACTCGGTCACATAGATCCAACGCGACGGTCATCCTACCCCGCAC
CCGCATGGACAGCTTCGCGGCCCCCAGTCATCCCGTTTCTTGGTTTAGTCCATTATCCTT
GCTACCGAAAAGTGGCCCGCAAGGAGGCTCTTATCTGCGCCCTAACACAAAGGAGGGTTG
AG
>Rosalind_0041
ACCACATCCGGCCACCTACGTGACAGACTCCGTAGGGACCTTCCTGAATGCTTGACGCCA
CTGCAGCGTCTCTACTTCGACTGTACTTGCTCAGAATTTACCCTAGAGTCACGCACTACA
CCTTCGGATACAGAGAATGAAAGTACCTAAGGTTATGCGGCCGAGCTACGATTCGTTAGC
AAGCTGTACTCTAGACGCTTACTCAGTCAAATATTGCCAACTTCGTCGTCATGCGTCCCA
AACCAGCCGTGCACCACAGCCACGACACCAGGCCCATCCGCAGGGCATGGGACATGCCTG
TCAGACGCGGCGCTAATCAGAATAGGAGAGAGAGTACCAGTCGCCCGTGTGGTAGACGTG
GGCGCTGTTGATAAAGTAGCGCTCAACAAACCAGAGATTGTTTTTCTTGGGTGTTCAGAA
ACGGCGGTGCATGCTAGCTTACTAGGCTCAGATGAACACGCGGTGTGAGCCACTGTTTTT
GCAAAGAGCGCCTGATTAATGGTGTGTTTGGAACGTACGGAATAGGAAACCTTCACGGGC
TCATGAAGAGACGCTTACCTCCGAATCCGAGTGGTTGATCAACATCTCCCGCGCGCGTAC
ACCGCATTGATAAAGATGCAGACTAGTGTACGTAAAATAGCTGTTACCTTACTCTTTCGT
CTCGGCTCGCATTGTGCGCTCAGCGCCATCTGGGTATAGTGTGCCCCATTTCCGTGTCCG
TGCTAGGCGACCACCCGCACACCCCTCGTCTGCGAGTACTCTCATCTTCGGACAGTGTTT
ATAACTGTGTAGCAGGTATTCAACGACCTGACTATGACATTGGAGCCAGCCGCTGCCCAC
TTACAAATGCCACTCCACAAGACACTCCGAGGTCCCGCCCCCAATTCTTGTAACTTACCT
TA
>Rosalind_7639
CTTGAAAGCTAAGCCGGGGCCTTTCATTTTCCAGCGAACTAAGGCAACCGCATGGTCACA
CTTAGCGTAACGAAGCCTGTCGACCCTACCGTAGGGCGCGAGGGCACTCGCCCCCTGCGA
GTAGTGCTGTAAGTCAGGACACTACAAGACCTGGCCTCGAAACCGGACACCTTGGCGTGC
TCTATAATCCTACCTGTAGCCCCCTGACCTACGTGTGAGAGGGTTGTGTGGCATCTCACC
GGGGGATATGTAAATCAGGGTAAGTATTCATACCGGGTGTTGCGTCTAAACCGTGCCTGA
TGACATAGAATCCACTTTCCCACTAACTGACCTTGCAGAGCTAAATAGTATCTTAAAGGA
TTACCCTGCAGGATTAAAAGTTGCGAGCCAACTCATCCGAAGCTCGGTGTAGGCGACGGT
ACAACCACGCAATCATCAATTTCTAGGCGATTGACCCGACCCTTCTCCCTAGAGCTCCCT
AAGGATATTACAACAAACAGTTTCTTGCAACACGAATGGTCGAAAGTATTTACGCAGGCC
TTTACGTGGACCCCGACGGAGTTTTTCAGCCGGCACTTTGAACTGAAGATGGCGGAAATT
ATATCGCTGAAGTAACACCGGTGTATCATCACATGACTTATTCCCGTCGAGGGGTGATTT
TATATATGCGATTTGTTATCTGCTTGGGGGAGGCCTAATGGGAATAACTGCGATGCCCAC
CCGAGGACCCCGAAACCTCAGAACCCGGGCCAACCAATATTCACCAGATCTGTGCGATGA
TAAATGCCGTCGCTGCATCGTGCATATGTCTGAGGGTTGAGGACAGATAGTGCCGCGATG
AGCCTACCTTTCTCTCAGCACCAGGCATGGTGACTCAAAAGCCCTCACGCATACATGCTC
CT
>Rosalind_3838
GGTGGTGCAACGAGGGGATCATGACAGTCGATGCTTGGAAAGAATGCCCTTAAACTGATC
TGTAGTGCTATATGCTAACTGTTCAAGAAACCTAACCGAAATTTCACATGTAAGCGTATG
TACTACAGAGTTGCGCAAAACCTATCGAAGTCAGCATAGTCGCTTCTTAGTGTTAATACG
GCTTAAGAGAACGCTAGCCAAGTGGAAGCTGTGCATGGAACAAACTTGATTCGTTAGCTG
ATTACGCAGGGTCCACTTCACGCCTGGTTGTGCCTATCGTGTGCGCTGTATCGCTTTCCG
GTTCCTTATCAGATTGTTTGATGACGCTTCGTGGTTATAGAGCCGTTCTTCGCCTTTCTC
TACCGTGATGATGGTCGACCCAAGCGGCTTTGAAGGACAGTAGGACTTCGTGGCGAAAGA
TCTGGCTACTGGCCATACATCACGACTTATTGTACGAGACATTATATCTGGACGATTATC
AACTCTGTTCGTATCTAATCTGCAATCCCATCAGTAAAGAGATGTCAGCGTATCCCGGTG
TCGATTGTGACTATAACCTGAAGGAGCCATATCTTTAGCCCCCTGTCCGATGCAAATTTG
CATAGCCCGCATGGGAGGTATGGGCCAGGATAAGCACGCCCGCGGGTGTTCGACCTCCCG
ACCGAGTCCTTACGATCGAGTTTTACGAGTATACTCGACCAATCACCCACCGGGTAAGTT
GGTAGAAGCCTAGCTGGAGTAAGTGACCCCAACCGGGGGTCTGCATCTAGTTGGGAGATC
TCCAAAACAGGTGATATGGTCTAGAGTTACGCTCGGTTCAAGCTACTAGCTCTGAACCCC
TAATGTATCACGCTTAGGAAGGGATATTGCTGTTGCCTCCGATGCCGTAGAGATATTGGG
CC
>Rosalind_6141
AACGAGGACGCCGATCTTTAATGCGTTCCTGGTGGACGAAATTTAATCTCAAAGTCATCC
ACCTCTCGAGGTATGATCTAGGGTTTGAGACCTATTCCCTCTTAAGTGTGCCACTAACCC
AAGTACAGGGTTTGAATAGTCTATTCAACCAGGAATTGGGGACGCCCTAACAGCGTCAAG
CTGGCTGACTCGAAAGAACGTAGCGCGCCATAAAATGGCCAGTTGCTTCCAACCAACTCG
GGCTTCTTGGCCCTCACCCTTCATTATAGGATAGGCCACTGGTCGGTTCCTTATGCTAAG
TTGTTCGCTCCTCCGAAGGCTCAGTGATCATTCGAGCGAAGCCCCCAGCACGCCATACCG
GCAGCAACCGCGAGCCCTAGGTAAACACCCCGCCGTTTCCGACAGATATAATGCGCATTA
CCTAAACTCGGTCCCTTATGAATCGTGACGGTGGTGGCGATGACATAATTATCGTCTGCG
ATCAAGCTCATATGTAACAGCTACTGCATCTGCACGAATAGAATATCATACTCAACCGGG
CGAGAGCTGTAATTTTTCGTCCCATAGACATGTTCCCTTGTTATCGCCCACGGCTCACGC
CGGAAAGCTAACTTTGCTGATAGACTGAGCCGTCTCTGTGGGGCGCCACAACATCAAAAC
ACAACTAGCGTATGGCCCTGAAGCATACAAACGAATGGTCTGAAACACAGTCTGTTACGC
TCCAAAGCCCGCCGTCCCCGGAGGTGGTAGTACGCTAGCGGGAAACATAAATCTGATATC
TATTAAAACCGATATGGTTCGTTGTGGGTCACCTCGGGGTTTAGAATCCCTAGCTGAACC
TATAATATCCGGTTCAGATCAAAAGAGGCGAATTCTCACTGTGGTCACCAGACTTAATTG
AC